111111111111111111111111111111111111111111111111111111111111
11111111111C11CCCC111111111111CCCC10000000000000000000011C11
1ZCCCCCCZZZ011C1CC1C11CCCCZCCCCZZC10111111111111111111011Z11
1ZC1111CCCCZ11C1C11C11CZZCZCZZZZZC10111CCCCCCCCCCC0000011Z11
1ZC01Z1111CZ11C1CCCC11CZZCCCZZCCCC10011C11111111111111111Z01
1Z10ZZP0Z1CZ11C1111C11CZZZZZZCCZZZZZC11C1C0000000011000000C1
1Z00ZZZ0Z1CZ11C1CCCC11CZZZZZZ0ZZZZZZC11C11111111101101111101
1Z0ZZCCC11CC11C1C11111CZZ00000ZZZZZZC11000000000001101100001
1ZCZZCZZZZ1C1101C1CC11CZZCCCCCCCCCCCC11111111111101101101111
1ZCCCCZCCCCCCCC1CCCC11CC1111111111ZZZZZZZZZZZZZ11C1101100001
1011111111111111Z11CCCCC1111111111110000000000000C1101111101
1C00000000000000000111111111111111110111111111111111011C1101
111111111111111101100000000000000ZZZ00000000000Z000001100001
11ZZZZZZZZZZZZZ101101111111011110101111ZZZZZZZ000ZZ001101111
11ZZZ11111111ZZ10000100000Z01000010001Z1Z1111ZZZZZ00Z1101111
11ZZ000000000Z111111001Z10Z01001110101ZZ11CC110000Z0Z1100001
11ZZ0ZZZZZZ0ZZZZ1Z1Z101ZZZZ010010001011ZZZZ1C1010110Z1111101
11ZZ0ZZZZSZ00ZZZZZ1Z10100000100001110ZZZ11CCZ1010010011C1101
11ZZ0ZZZZ0ZZ0ZZZZZZ100101111110111C00ZCZC1111101001001100001
11ZZ0ZZZZ0ZZ0ZZZZ1Z1101001000100010ZZCZCZZ000101101101101111
11ZZ0ZZZZ0000ZZZZ1Z100110101011101000000000Z0101100001101C01
1111011111111111111101100101000001111111111Z0001001111101101
1000000000000001000100101101111111000000001ZZZ01101CZ1101101
100000000000010001000100010C100001011111101Z0001001ZZ1100001
100000000000111111110101011110101101ZE01001Z01110111011ZZZ11
10000000000100C1000101010100001001011101011100010010011ZZZ11
1000000011110111010101010101111101000001001C11001001011ZCZ11
10011111000101000100010101010000011111111CZ000000100011ZZZ11
10100001010101011111110101010011111ZZZZZ101011111C11011ZZZ11
100011000100010000000001000100000ZZZ11ZZZZ1000000000011ZZZ11
111111111111111111111111111111111111111111111111111111111111
