111111111
1E00000C1
1000000C1
1000000C1
1000000C1
1P00000C1
111111111
