111111111
1CCCCCCC1
1CCZZZZC1
1CCZPESC1
1CCZZ0ZC1
1CCC0CCC1
111111111
