1111111111111
11111E0000C11
1111111111111
1111111111001
1111111111001
1111111111001
1111111111001
11111111111P1
1111111111111
